4444444444444444444444444444444000000000000000000000000000000000000000000044444444444444444444444444
4444444444444444444444444444444000000000000000000000000000000000000000000044444444444444444444444444
4444444444444444444444444444444444444444444444444444444444444444444444444444444444444444444444444444
4444444444444444444444444444444444444444444444444444444444444444444444444444444444444444444444444444
4444444444444444444444444444444444444444444444444444444444444444444444444444444444444444444444444444
4444444444444444444444444444444444444444444444444444444444444444444444444444444444444333333444444444
4444444444444444444444444444444444444444444444444444444444444444444444444444444444444333333444444444
4444444444444444444444444444441111111111111111111111111111111111111111111114444444444333333444444444
4444444444444444444444444444441000000000000000000000000000000000000000000044444444444333333444444444
4444444444444444444444444444441000000000000000000000000000000000000000000044444444444333333444444444
4444444444444444444444444444441000000000000000000000000000000000000000000044444444444333333444444444
4444444444444444444444444444441000000000000000000000000000000000000000000044444444444333333444444444
4444444444444444444444444444441000000000000000000000000000000000000000000044444442222333333444444443
4444444444444444444444444444441000000000000000000000000000000000000000000044444442222333333444444443
4444444444444444444444444444441000000000000000000000000000000000000000000044444442222333333444444443
4444444444444444444444444444441000000000000000000000000000000000000000000044444442222333333444444443
4444444444444444444444444444441000000000000000000000000000000000000000000011111112222333333444444443
4444444444444444444444444444441000000000000000000000000000000000000000000011111112222333333444444443
4444444444444444444444444444441000000000000000000000000000000000000000000011111112222444444444444443
4444444444444444444444444444441000000000000000000000000000000000000000000011111112222444444444444443
4444444444444444444444444444441000000000000000000000000000000000000000000011111112222444444444444443
4444444444444444444444444444441000000000000000000000000000000000000000000011111112222444444444444443
4444444444444444444444444444441000000000000000000000000000000000000000000011111112222444444444444443
4444444444444444444444444444441000000000000000000000000000000000000000000011111112222444444444444443
4444444444444444444444444444441000000000000000000000000000000000000000000011111112222444444444444443
4444444444444444444444444444441000000000000000000000000000000000000000000011111112222444444444444443
4444444444444444444444444444441000000000000000000000000000000000000000000011111112222444444444444443
4444444444444444444444444444441000000000000000000000000000000000000000000011111112222444444444444443
4444444444444444444444444444441000000000000000000000000000000000000000000011111112222444444444444443
4444444444444444444444444444441000000000000000000000000000000000000000000011111112222444444444444443
4444444444444444444444444444441000000000000000000000000000000000000000000011111112222444444444444443
4444444444444444444444444444441000000000000000000000000000000000000000000011111112222444444444444443
4444444444444444444444444444441000000000000000000000000000000000000000000011111112222444444444444443
4444444444444444444444444444441000000000000000000000000000000000000000000011111112222444444444444443
4444444444444444444444444444441000000000000000000000000000000000000000000011111112222444444444444443
4444444444444444444444444444441000000000000000000000000000000000000000000011111112222444444444444443
4444444444444444444444444444441000000000000000000000000000000000000000000011111112222444444444444443
4444444444444444444444444444441000000000000000000000000000000000000000000011111112222444444444444443
4444444444444444444444444444441000000000000000000000000000000000000000000011111112222444444444444443
4444444444444444444444444444441444444444444444444444444444444444444444444411111112222444444444444443
4444444444444444444444444444441444444444444444444444444444444444444444444411111112222444444444444443
4444444444444444444444444444441444444444444444444444444444444444444444444411111112222444444444444443
4444444444444444444444444444441444444444444444444444444444444444444444444411111112222444444444444443
4444444444444444444444444444441444444444444444444444444444444444444444444411111112222444444444444443
4444444444444444444444444444441444444444444444444444444444444444444444444411111112222444444444444443
4444444444444444444444444444441000000000000000000000000000000000000000000011111112222444444444444443
4444444444444444444444444444441000000000000000000000000000000000000000000011111112222444444444444443
4444444444444444444444444444441000000000000000000000000000000000000000000011111112222444444444444443
4444444444444444444444444444441000000000000000000000000000000000000000000011111112222444444444444443
4444444444444444444444444444441000000000000000000000000000000000000000000011111112222444444444444443
4444444444444444444444444444441000000000000000000000000000000000000000000011111112222444444444444443
4444444444444444444444444433331000000000000000000000000000000000000000000011111112222444444444444443
4444444444444444444444444433331000000000000000000000000000000000000000000011111112222444444444444443
4444444444444444444444444433321000000000000000000000000000000000000000000011111112222444444444444443
4444444444444444444444444433321000000000000000000000000000000000000000000011111112222444444444444443
4444444444444444444444444433321000000000000000000000000000000000000000000011111112222444444444444443
4444444444444444444444444433321000000000000000000000000000000000000000000011111112222444444444444443
4444444444444444444444444433321000000000000000000000000000000000000000000011111112222444444444444443
4444444444444444444444444433321000000000000000000000000000000000000000000011111112222444444444444443
4444444444444444444444444433321000000000000000000000000000000000000000000011111112222444444444444443
4444444444444444444444444433331000000000000000000000000000000000000000000011111112222444444444444443
4444444444444444444444444433331000000000000000000000000000000000000000000011111112222444444444444443
4444444444444444444444444444441000000000000000000000000000000000000000000011111112222444444444444443
4444444444444444444444444444441000000000000000000000000000000000000000000011111112222444444444444443
4444444444444444444444444444441000000000000000000000000000000000000000000011111112222444444444444443
4444444444444444444444444444441000000000000000000000000000000000000000000011111112222444444444444443
4444444444444444444444444444441000000000000000000000000000000000000000000011111112222444444444444443
4444444444444444444444444444441000000000000000000000000000000000000000000011111112222444444444444443
4444444444444444444444444444441444444444444444444444444444444444444444444411111112222444444444444443
4444444444444444444444444444441444444444444444444444444444444444444444444411111112222444444444444443
4444444444444444444444444444441444444444444444444444444444444444444444444411111112222444444444444443
4444444444444444444444444444441444444444444444444444444444444444444444444411111112222444444444444443
4444444444444444444444444444441444444444444444444444444444444444444444444411111112222444444444444443
4444444444444444444444444444441444444444444444444444444444444444444444444411111112222444444444444443
4444444444444444444444444444441000000000000000000000000000000000000000000011111112222444444444444443
4444444444444444444444444444441000111111111111111111111111111110000000000011111112222444444444444443
4444444444444444444444444444441000111111122222222222222111111110000000000011111112222444444444444443
4444444444444444444444444444441000111111122223333333332111111110000000000011111112222444444444444443
4444444444444444444444444444441000111111122223333433211111111000000000001111111222244444444444444333
4444444444444444444444444444441000111111122223333433211111111000000000001111111222244444444444444333
4444444444444444444444444444441000111111122222222222222111111110000000000011111112222444444444444443
4444444444444444444444444444441000111111122222222222222222221110000000000011111112222444444444444443
4444444444444444444444444444441000111111111111111111122222221110000000000011111112222444444444444443
4444444444444444444444444444441000111111111111111111122222221111111111000011111112222444444444444443
4444444444444444444444444444441000000000000000000011122222222222222111000011111112222444444444444443
4444444444444444444444444444441000000001100000000011122222333333222111000011111112222444444444444443
4444444444444444444444444444441000000002200000000011122222333333222111000011111112222444444444444443
4444444444444444444444444444441000000003300000000011111122333333222111000011111112222444444444444443
4444444444444444444444444444441000004444444400000011111122222222111111000011111112222444444444444443
4444444444444444444444444444441000004444444400000011111122222222111111000011111112222444444444444443
4444444444444444444444444444441000004444444400000011111122444422111111000011111112222444444444444443
4444444444444444444444444444441000004444444400000011111122222222111111000011111112222444444444444443
4444444444444444444444444444441000004444444400000011111111111111111111000011111112222444444444444443
4444444444444444444444444444441000000003300000000000000000000000000000000011111112222444444444444443
4444444444444444444444444444441000000003300000000000000000000000000000000011111112222444444444444443
4444444444444444444444444444441444444444444444444444444444444444444444444411111112222333444444444443
4444444444444444444444444444444444444444444444444444444444444444444444444411111112222333444444444443
4444444444444444444444444444444444444444444444444444444444444444444444444411111112222333444444444443
4444444444444444444444444444444444444444444444444444444444444444444444444411111112222333444444444443
4444444444444444444444444444444444444444444444444444444444444444444444444411111112222333444444444443