4444444444444444444444444444444000000000000000000000000000000000000000000033333333333333333333333333
4444444444444444444444444444444001111111111111111110000000000000000000000033333333333333333333333333
4444333333333333333333444444444444422222222222222222222233333333333333444433333333333333333333333333
4444333333333333333333444444444444444444444444444444444433333333333333444433333333333333333333333333
4444333333333333333333444444444444444444444444444444444444444444444444444444444444444444444444444444
4444333333333333333333444444444444444444444444444444444444444444444444444444444444444333333444444444
4444333333333333333333444444444444444444444444444444444444444444444444444444444444444333311114444444
4444333333332222222222224444441111111111111111111111111111111111111111111114444444444333310014444444
4444333333332222222222224444441000000000000000000000000000000000000000000044444444444333333444444444
4444333333332222222222224444441000000000000000000000011111111111111111111144444444444333322222222444
4444333333332222222222224444441000000000000000000000011113333333333333111144444444444333322222222444
4444444444442222222222224444441000002222222222222222211113333333333333111144444444444333322222222444
4444444444442222222222224444441000002222222222222222211113333333333333111144444442222333322222222443
4444444444442222222222224444441000002222222222223333211111111111111111111144444442222333322222222443
4444444444442222222222224444441000002222222222223333222200000000000000000044444442222333333444444443
4444444444444444444444444444441000002222222222223333222222222222000000000044444442222333333444444443
4444444444444444444444444444441000002222222222223333222222222222000000000011111112222333333444444443
4444444444444444444444444444441000000000000000003333333333332222000000000011111112222333333444444443
4444444444444444444444444444441000000000000000002233344443332222000000000011111112222444444444444443
4444444444444444444444444444441000000000000000002233344443332222000000000011111112222444411111444443
4444444444444444444444444444441000000000000000002233333333332222000000000011111112222444411211444443
4444444444444444444444444444111111111111111111112222222222222222000000000011111112222444411111444443
4444444444444444444444444444111111111111111111112222222222222222000000000011111112222444444411114443
4444444444444444444444444444111111113333311111111111111111110000000000000011111112222444444222222443
4444444444444444444444444444111111113433322222222222222222110000000000000011111112222444433333222443
4444444444444444444444444444111111113433322222222222222222110000000000000011111112222444433333222443
4444444444444444444444444444111122222422111111111111111111110000000000000011111112222444433333222443
4444444444444444444444444444111122222422112222222222222222222222220000000011111112222444433333222443
4444444444444444444444444444111122222422112222222222222222222222220000000011111112222444433333222443
4444444444444444444444444444111122222222112222222222222222222222220000000011111112222444433333222443
4444444444444444444444444444111111111111112222222222222222222222220000000011111112222444433333222443
4444444444444444444444444444441000000000002222222222222222222222220000000011111112222444433333222443
4444444444444444444444444444441000000000002222222222222222222222220000000011111112222444433333222443
4444444444444444444444444444441000000000002222222222222222222222221111111111111112222444433222222443
4444444444444444444444444444441000000000002222222222222222222222221111111111111112222444433222222443
4444444444444444444444444444441000000000002222222222222222222222221111111111111112222444433222222443
4444444444444444444444444444441000000000000000111111111111111111111111111111111112222444433333444443
4444444444444444444444444444441000000000000000111111111111111111111111111111111112222444433333444443
4444444444444444444444444444441000000000000000111111111111111111111111111111111112222444433333444443
4444444444444444444444444444441444444444444444444444444444444444444444444411111112222444433333444443
4444444444444444444444444444441444444444444444333333333333333333334444444411111112222444433333444443
4444444444444444444444444444441444444444422222222222222223333333334444444411111112222444433333444443
4444444444444444444444444444441444444444422222222222222223333333334444444411111112233333333333444443
4444444444444444444444444444441444444444444444333333333333333333334444444411111112233333333344444443
4444444444444444444444444444441444444444444444444444444444444444444444444411111112233333333344444443
4444444444444444444444444444411111110000000044444444444444400000000000111111111112233333333344444443
4444444444444444444444444444411111110000000000000000000000000000000000000011111112233333333344444443
4444444444444444444444444444411111110011111111111111111111111111000000000011111112233333333344444443
4444444444444444444444444444441000000011111111111111111111111111000000001111111112222444444444444443
4444444444444444444444444444442222000011111111222222222222222222220000001111111112222444444444444443
4444444444444444444444444444442222000011111111222222222222222222220000001111111112223333333334444443
4444444444444444444444444433331000000011111111222233333332222222220000001111111112223333333334444443
4444444444444444444444444433331000000011111111222233333332222222220000001111111112223333333333333443
4444444444444444444444444433321000000011111333333333333333333222220000000011111222223333333333333443
4444444444444444444444444433321000000011111333333333333333333222220000000011111222223333333333333443
4444444444444444444444444433321000111111111333334444444444433222221111100011111222223333333333333443
4444444444444444444444444433321111111111111333334444444444433222221111100011111222223333333333333443
4444444444444444444444444433321111111112222333334444433333433333322111111111111222223333333333333443
4444444444444444444444444433321111111112222333334442233333433333322111111111111222223333333334444443
4444444444444444444444444433321111111112222333334444433333433222222111111111111112223333333334444443
4444444444444444444444444433331111111112222333334444444444433222222111100011111112223333333334444443
4444444444444444444444444433331111111112222223332222222222222222222111100011111112223333333334444443
4444444444444444444444444444441000111111111223332222111111111111111111100011111112222444444444444443
4444444444444444444444444444441000111111111222222222111111100000000000001111111112222444444444444443
4444444444444411111111111111111000111111111222222222111111111110000000001111111112222444444444333333
4444444444444411111111111111111000111111111111111111111111111111111110001111111112222444444444332222
4444444444444411111111111111111000000000000000000000000000000000111110000011111112223333444444332222
4444444444444411111111111111111000000000000044444444444444444400000000000011111112223333444444332222
4444444444411111111111111111111444444444444444444444444444444444444444444411111112223333444444333333
4444444444411111111111111111111333333333333333333333333333333333333334444422222222223333444444444443
4444444444411111111111111111111322222222222222222222222222222222222333333322222222223333444444444443
4444444444411111111111111114441333333333333333333333333333333333333222222222233333333333333333334443
4444444444411111111111111114441333333333333333333333333333333333333333333322233333333333332222334443
4444444444411111111111111114441444444444444444444444444444444444444444444422233333333333332222334443
4444444444411111111111111114441000000000000000000000000000000000000000000022233333333333222222334443
4444444444411111111111111114441000111111111111111111111111111110000000000022233333333333222222334443
4444444444411222222222221111111000111111122222222222222111111110000022000022222222223333222222334443
4444444444444222222222221111111000111111122223333333332111111110000022000022222222223333222233334443
4444444444444222222222221111111000111111122223333433211111111000000011001111111222243333222233334333
4444444444444222222222221111111000111111122223333433211111111000000011001111111222243333222233334333
4444444444444222222222224444441000111111122222222222222111111110000022000011111112223333222233334443
4444444444444222222222224444441000111111122222222222222222221110000000000011111112222433333333334443
4444444444444444444444444444441000111111111111111111122222221110000000000011111112222433333333334443
4444444444444444444444444444441000111111111111111111122222221111111111000011111112222433333333334443
4444444443333333333444444444441000000000000000000011122222222222222111000011111112222433322222222443
4444444443333333333444444444441000000001100000000011122222333333222111000011111112222433322222222443
4444444443333333333111444444441000000002200000022011122222333333222111000011111112222433322111122443
4444444443332222233111444444441000000003300000022011111122333333222111000011111112222433322111122443
4444444441111111111111444444441000004444444400022011111122222222111111000011111112222433333111134443
4444444444444444411111111111111000004444444400000011111122222222111111000011111112222433333111134443
4444444444111111111111111111111000004444444400000011111122444422111111000011111112222433333111134443
4444444444111111333333333331111000004444444400000011111122222222111111000011111112222433333333334443
4444444444112222222222333331111000004444444400000011111111111111111111000011111112222433333333334443
4444444444112222222222333331111000000003300000000000000000000000000000000011111112222443333333444443
4444444444111111333333333331111000000003300000000000000000000000000000000011111112222443322222444443
4444444444444444411111111111111444444444444444444444444444444444444444444411111112222333322111444443
4444444444444442222222222222222222444444444444444444444444444444444333322211111112222333322111444443
4444444444444444444433333333333333333333334444444444444444444443333333322211111112222333322222444443
4444444444444444444444444444444444444444444444444444444444444443333333322211111112222333333333444443
4444444444444444444444444444444444444444444444444444444444444444444333344411111112222333444444444443